R 640 480
NO ./texture/book64.xpm
SO ./texture/nam64.xpm 
WE ./texture/seo64.xpm
EA ./texture/dong64.xpm
S ./texture/fire.xpm
F 110,153,15 
C 255,255,255
11111111111111
11111111111111
10000000000001
10001000100001
10000000000001
100000S0000001
10000010000001
10000000000001
11111111111111
11111111111111