R 1920 1080              
NO ./assets/texture/book64.xpm
SO ./assets/texture/nam64.xpm





WE ./assets/texture/seo64.xpm
S ./assets/texture/meer64.xpm

C 225, 30, 0
EA ./assets/texture/dong64.xpm
F 220, 100, 0

        1111111111111111111111111
        1000000000000000000000001
        1100000000000000000000001
        100000020000000000000001
111111111000000000000000000000001

100000000000000000000000000001111
10000000000000N10000000000001
10000000000000000000000000001
1000000000000000000000000001
10000000000000000000000000001
10000000000000000001010000001
11000001110101011111011110101
11110111 1110121 101111010001
11111111 1111111 111111111111